/////////////////////////
/                       /
/                       /
/                       /
/                       /
/                       /
/                       /
/                       /
/                       /
/                       /
/ P       H             /
/                       /
/                       /
/                       /
/                       /
/                       /
/                       /
/                       /
/         D             /
/                       /
/                       /
/                       /
/                       /
/                       /
/////////////////////////