/////////////////////////
/                       /
/                       /
/                       /
/                       /
/                       /
/                       /
/                       /
/                       /
/                       /
/ P       R             /
/                       /
/                       /
/                       /
/                       /
/                       /
/                       /
/                       /
/         D             /
/                       /
/                       /
/                       /
/                       /
/                       /
/////////////////////////