"/////////////////////////"
"/E0000000000000000000000/"
"/00000000000000000000000/"
"/00000000000000000000000/"
"/00000000000000000000000/"
"/00000K00000000000000000/"
"/00000000000000000000000/"
"/00000000000000000000000/"
"/00000000000000000000000/"
"/00000000000000000K00000/"
"/00000000000000000000000/"
"/00000K00000000000000000/"
"/00000000000000000000000/"
"/00000000000P00000000000/"
"/00000000000000000000000/"
"/00000000000000000000000/"
"/00000000000000000000000/"
"/00000000000000000000000/"
"/00000000000000000000000/"
"/00000000000000000000000/"
"/00000000000000000000000/"
"/00000000000000000000000/"
"/00000000000000000000000/"
"/E000000000000000000000E/"
"/////////////////////////"