"/////////////////////////"
"/                       /"
"/                       /"
"/                       /"
"/                       /"
"/                       /"
"/                       /"
"/                       /"
"/                       /"
"/                       /"
"/                       /"
"/ P         R           /"
"/                       /"
"/                       /"
"/                       /"
"/                       /"
"/                       /"
"/                       /"
"/                 D     /"
"/                       /"
"/                       /"
"/                       /"
"/                       /"
"/                       /"
"/////////////////////////"