/////////////////////////
/               EE   D  /
/  Y            EE    EE/
/Y              EEE   EE/
/  Y                    /
/                       /
/    ////////////////////
/          X    X   /////
/   X    X    X  X  /  K/
/                   /////
/                       /
/                       /
/EEEEEEEEEEEEEEEEEEEEEEE/
/                       /
/                    K  /
/////////////////////////
/YYYYYYY   XXXXXXXXXXXX /
/                       /
/ ////// ////////////////
/                       /
/   K                 Y /
//////////////////  Y   /
/   P            /   Y  /
/                /      /
/////////////////////////