/////////////////////////
/                       /
/                       /
/                       /
/                       /
/                       /
/             M         /
/                       /
/                       /
/  P                    /
/                       /
/                       /
/                       /
/             H         /
/                       /
/                       /
/                       /
/                       /
/                       /
/                       /
/                D      /
/                       /
/                       /
/                       /
/////////////////////////