/////////////////////////
/ P                   Y /
/                       /
///////////////////     /
/                       /
/                       /
/       ////////////    /
/                     K /
/                    ////
/                       /
/  X             /      /
/                /      /
/    X           /  X   /
/                /      /
/      X         /      /
/                /    X /
/        X       /      /
/                / X    /
/           X    /      /
/             X  /   K  /
/                       /
/                       /
/           D           /
/                       /
/////////////////////////