/////////////////////////
/                       /
/  P              /  K  /
/                 ///////
/                       /
/                       /
/                       /
/                       /
/                       /
/                       /
/                       /
/                       /
//////////// ////////////
/                       /
/                       /
/                       /
/                       /
/                       /
/                       /
/                       /
/           D           /
/                       /
/                       /
/                       /
/////////////////////////